1111111111111111111111
10010000000C1111101111
1110000000000000001111
10C0011011001101101111
1P0011E000001111101111
1111111111111111111111